Débutant
+---+---+---+---+
| F |   | T | K |
+---+---+---+---+
|   | C |   | Q |
+---+---+---+---+
| P |   | P |   |
+---+---+---+---+
| C | T |   | P |
+---+---+---+---+